1111111111111111111111111111111111
1E0000000000000C00000C000000000001
101001010010000C101001000000010101
1C1001001010101C001001000000010101
1PC000000C00C00C0000000000000000C1
1111111111111111111111111111111111
