NO assets/textures/simonkraft/respawn_anchor_side0.png
EA assets/textures/simonkraft/respawn_anchor_side2.png
SO assets/textures/simonkraft/respawn_anchor_side4.png
WE assets/textures/simonkraft/respawn_anchor_side3.png

C 77,77,77
F 33,33,33

11111
10001
10N01
10001
11111
