
WE assets/textures/west_texture.png
NO assets/textures/north_texture.png
SO assets/textures/south_texture.png
EA assets/textures/east_texture.png

C 225,30,0
F 220,200,0

11111111111111111111111111111111111111111111111111111111111111
10000000000000000000000000000000000000000000000000000000000001
10000000011111100000000110001110000011001111110011111000000001
10000001110000110011100110000110000011001000000110001100000001
10000000110000110000000110000110010011000111100000001100000001
10000000110000110011100110000110101011000001100000001100000001
10000000110000110000000111000111000111000011100000001100000001
100000000000000000000000000S0000000000000000000000000000000001
10000000000000000000000000000000000000000000000000000000000001
10111000111100111000011000011111100011111100111110001110001101
10011001011000011000011001110000110010000000000011000110001101
10011010011000011110011000110000110001111001110011000110001101
10011100011000011011011000110000110000011001100011000110001101
10011000011000111000111000110000110000111000111110000011111001
10000000000000000000000000000000000000000000000000000000000001
10000000000000000000111000000000000000000000000000000000000001
10000000000000000000011000000000000000000000000000000000000001
10000000000000000000000000000000000000000000000000000000000001
10000000000000000000110000000000000000000000000000000000000001
10000000001110000000000000000000000000000000000000000000000001
10000000000110011100110001111111000011111000011111000000000001
10000000000110001100110011000001100110001100110001100000000001
10000000000110001100110011011001100000001100000001100000000001
10000000000110001100110011001001100000001100000001100000000001
10000000000111000111100001110001100000001100000011100000000001
10000000000000000000000000000000000000000000000000000000000001
11101111111111111111111111111111111111111111111111111111111111
  101
111011
100001
111111


     1111
   111






